###############################
#S     22 1  1 2 2 1  1 1 1  S#
#   #  1#   #1#1# #   #  1#1# #
#  11     222  1  1   1     1 #
#   #   # #1#   #1#   #     #2#
#1         1 11  1  1   1     #
#   #   #   #   # #1#     # # #
#1  1      1  1      1        #
#   #   #1# #   #1#       # # #
#1    11  1       1           #
#  1# # #   # # #1# #     # # #
#S          1   1  1         S#
###############################